//MAP CONVERTED BY dmm2tgm.py THIS HEADER COMMENT PREVENTS RECONVERSION, DO NOT REMOVE
"aR" = (
/turf/simulated/floor/plasteel/lavaland_air{
	icon_state = "cautionfull"
	},
/area/ruin/unpowered/misc_lavaruin)
"bu" = (
/obj/structure/cable/orange{
	icon_state = "0-8"
	},
/obj/item/mounted/frame/apc_frame{
	pixel_x = -16
	},
/turf/simulated/floor/plasteel/lavaland_air,
/area/ruin/unpowered/misc_lavaruin)
"bw" = (
/obj/item/stack/tile,
/obj/structure/table_frame,
/turf/simulated/floor/plating/lavaland_air,
/area/ruin/unpowered/misc_lavaruin)
"bE" = (
/obj/structure/cable/orange{
	icon_state = "0-4"
	},
/obj/item/mounted/frame/apc_frame{
	pixel_x = 3;
	pixel_y = -8
	},
/turf/simulated/floor/plating/lavaland_air,
/area/ruin/unpowered/misc_lavaruin)
"cd" = (
/obj/machinery/suit_storage_unit/lavaland,
/obj/effect/mapping_helpers/machinery/damaged,
/turf/simulated/floor/plasteel/lavaland_air{
	icon_state = "brown";
	dir = 4
	},
/area/ruin/unpowered/misc_lavaruin)
"cJ" = (
/turf/template_noop,
/area/template_noop)
"dA" = (
/obj/effect/decal/cleanable/glass,
/obj/item/shard,
/turf/simulated/floor/plasteel/lavaland_air,
/area/ruin/unpowered/misc_lavaruin)
"en" = (
/turf/simulated/wall,
/area/ruin/unpowered/misc_lavaruin)
"fC" = (
/obj/effect/decal/cleanable/glass,
/obj/structure/grille/broken,
/turf/simulated/floor/plating/lavaland_air,
/area/ruin/unpowered/misc_lavaruin)
"fG" = (
/obj/structure/shuttle/engine/heater{
	dir = 4
	},
/obj/structure/window/reinforced{
	dir = 1
	},
/obj/structure/window/reinforced{
	dir = 8
	},
/turf/simulated/floor/plating/lavaland_air,
/area/ruin/unpowered/misc_lavaruin)
"fW" = (
/obj/structure/cable/orange{
	icon_state = "1-8"
	},
/turf/simulated/floor/catwalk,
/area/ruin/unpowered/misc_lavaruin)
"ga" = (
/obj/structure/grille,
/turf/simulated/floor/plating/lavaland_air,
/area/ruin/unpowered/misc_lavaruin)
"gb" = (
/obj/effect/turf_decal/stripes/red/line,
/obj/effect/turf_decal/stripes/red/line{
	dir = 8
	},
/turf/simulated/floor/plasteel/lavaland_air{
	icon_state = "titanium"
	},
/area/ruin/unpowered/misc_lavaruin)
"gu" = (
/obj/item/stack/sheet/metal,
/turf/simulated/floor/plasteel/lavaland_air{
	icon_state = "cautionfull"
	},
/area/ruin/unpowered/misc_lavaruin)
"hi" = (
/obj/structure/cable/orange{
	icon_state = "2-4"
	},
/turf/simulated/floor/catwalk,
/area/ruin/unpowered/misc_lavaruin)
"hp" = (
/turf/simulated/floor/plasteel/lavaland_air{
	icon_state = "brown";
	dir = 1
	},
/area/ruin/unpowered/misc_lavaruin)
"hx" = (
/obj/structure/girder,
/turf/simulated/floor/plating/lavaland_air,
/area/ruin/unpowered/misc_lavaruin)
"hR" = (
/obj/structure/ore_box,
/turf/simulated/floor/plasteel/lavaland_air,
/area/ruin/unpowered/misc_lavaruin)
"im" = (
/obj/structure/cable/orange{
	icon_state = "2-8"
	},
/turf/simulated/floor/plasteel/lavaland_air{
	icon_state = "brown";
	dir = 4
	},
/area/ruin/unpowered/misc_lavaruin)
"iO" = (
/obj/structure/rack,
/turf/simulated/floor/plasteel/lavaland_air,
/area/ruin/unpowered/misc_lavaruin)
"jw" = (
/obj/structure/shuttle/engine/heater{
	dir = 4
	},
/obj/structure/window/reinforced{
	dir = 8
	},
/turf/simulated/floor/plating/lavaland_air,
/area/ruin/unpowered/misc_lavaruin)
"ko" = (
/obj/structure/table,
/obj/item/storage/box/donkpockets{
	pixel_x = 5;
	pixel_y = 8
	},
/obj/item/storage/box/donkpockets/empty,
/turf/simulated/floor/plating/lavaland_air,
/area/ruin/unpowered/misc_lavaruin)
"kX" = (
/obj/machinery/suit_storage_unit,
/obj/effect/mapping_helpers/machinery/damaged,
/turf/simulated/floor/plasteel/lavaland_air{
	icon_state = "brown";
	dir = 8
	},
/area/ruin/unpowered/misc_lavaruin)
"ll" = (
/obj/structure/cable/orange{
	icon_state = "2-8"
	},
/turf/simulated/floor/plasteel/lavaland_air{
	icon_state = "browncorner";
	dir = 1
	},
/area/ruin/unpowered/misc_lavaruin)
"lT" = (
/obj/machinery/power/port_gen/pacman/mrs,
/obj/structure/cable/orange,
/obj/effect/mapping_helpers/machinery/damaged,
/turf/simulated/floor/catwalk,
/area/ruin/unpowered/misc_lavaruin)
"lW" = (
/obj/structure/cable/orange{
	icon_state = "1-8"
	},
/turf/simulated/floor/plating/lavaland_air,
/area/ruin/unpowered/misc_lavaruin)
"ms" = (
/obj/structure/chair/comfy/shuttle{
	dir = 8
	},
/turf/simulated/floor/plasteel/lavaland_air{
	icon_state = "titanium"
	},
/area/ruin/unpowered/misc_lavaruin)
"nt" = (
/obj/effect/spawner/window/shuttle,
/obj/effect/mapping_helpers/damaged_window,
/turf/simulated/floor/plating/lavaland_air,
/area/ruin/unpowered/misc_lavaruin)
"nz" = (
/obj/effect/turf_decal/stripes/red/line,
/turf/simulated/floor/plasteel/lavaland_air{
	icon_state = "titanium"
	},
/area/ruin/unpowered/misc_lavaruin)
"ov" = (
/obj/effect/decal/cleanable/glass,
/obj/structure/grille/broken,
/obj/item/shard{
	icon_state = "small"
	},
/turf/simulated/floor/plating/lavaland_air,
/area/ruin/unpowered/misc_lavaruin)
"oC" = (
/obj/structure/cable/orange{
	icon_state = "1-2"
	},
/obj/structure/cable/orange{
	icon_state = "1-8"
	},
/turf/simulated/floor/plasteel/lavaland_air{
	icon_state = "brown";
	dir = 4
	},
/area/ruin/unpowered/misc_lavaruin)
"oU" = (
/obj/machinery/door/airlock/external/glass,
/turf/simulated/floor/plasteel/lavaland_air{
	icon_state = "titanium_yellow"
	},
/area/ruin/unpowered/misc_lavaruin)
"po" = (
/obj/effect/spawner/window/reinforced/grilled,
/obj/effect/mapping_helpers/damaged_window,
/turf/simulated/floor/plating/lavaland_air,
/area/ruin/unpowered/misc_lavaruin)
"pu" = (
/obj/structure/table_frame,
/obj/machinery/chem_dispenser/beer{
	pixel_y = 5
	},
/obj/effect/mapping_helpers/machinery/destroyed,
/turf/simulated/floor/plasteel/lavaland_air{
	icon_state = "cautionfull"
	},
/area/ruin/unpowered/misc_lavaruin)
"pv" = (
/turf/simulated/floor/plasteel/lavaland_air,
/area/ruin/unpowered/misc_lavaruin)
"qP" = (
/obj/item/shard{
	pixel_x = 11
	},
/obj/structure/table,
/obj/machinery/kitchen_machine/microwave{
	pixel_x = -3;
	pixel_y = 6
	},
/turf/simulated/floor/plasteel/lavaland_air{
	icon_state = "cautionfull"
	},
/area/ruin/unpowered/misc_lavaruin)
"ra" = (
/obj/machinery/suit_storage_unit,
/turf/simulated/floor/plasteel/lavaland_air{
	icon_state = "brown";
	dir = 4
	},
/area/ruin/unpowered/misc_lavaruin)
"rp" = (
/obj/structure/cable/orange{
	icon_state = "1-2"
	},
/turf/simulated/floor/plasteel/lavaland_air{
	icon_state = "brown";
	dir = 4
	},
/area/ruin/unpowered/misc_lavaruin)
"sh" = (
/obj/item/shard{
	icon_state = "small"
	},
/turf/simulated/floor/plating/lavaland_air,
/area/ruin/unpowered/misc_lavaruin)
"su" = (
/obj/item/shard{
	icon_state = "small"
	},
/turf/simulated/floor/plasteel/lavaland_air,
/area/ruin/unpowered/misc_lavaruin)
"sD" = (
/obj/structure/cable/orange{
	icon_state = "1-2"
	},
/turf/simulated/floor/plasteel/lavaland_air,
/area/ruin/unpowered/misc_lavaruin)
"sE" = (
/obj/effect/turf_decal/stripes/red/line{
	dir = 8
	},
/turf/simulated/floor/plasteel/lavaland_air{
	icon_state = "titanium"
	},
/area/ruin/unpowered/misc_lavaruin)
"tB" = (
/obj/structure/mecha_wreckage/ripley/firefighter,
/turf/simulated/floor/plasteel/lavaland_air,
/area/ruin/unpowered/misc_lavaruin)
"um" = (
/obj/structure/cable/orange{
	icon_state = "1-2"
	},
/obj/machinery/door/airlock/mining,
/turf/simulated/floor/plasteel/lavaland_air,
/area/ruin/unpowered/misc_lavaruin)
"vp" = (
/obj/structure/shuttle/engine/heater{
	dir = 4
	},
/obj/structure/window/reinforced,
/obj/structure/window/reinforced{
	dir = 8
	},
/turf/simulated/floor/plating/lavaland_air,
/area/ruin/unpowered/misc_lavaruin)
"vw" = (
/turf/simulated/floor/plasteel/lavaland_air{
	icon_state = "titanium_yellow"
	},
/area/ruin/unpowered/misc_lavaruin)
"wt" = (
/obj/item/stack/sheet/metal,
/turf/simulated/floor/plasteel/lavaland_air,
/area/ruin/unpowered/misc_lavaruin)
"wA" = (
/obj/structure/chair/comfy/shuttle{
	dir = 8
	},
/obj/effect/turf_decal/stripes/red/line,
/turf/simulated/floor/plasteel/lavaland_air{
	icon_state = "titanium"
	},
/area/ruin/unpowered/misc_lavaruin)
"xf" = (
/turf/simulated/floor/plasteel/lavaland_air{
	icon_state = "titanium"
	},
/area/ruin/unpowered/misc_lavaruin)
"yA" = (
/turf/simulated/floor/plasteel/lavaland_air{
	icon_state = "brown"
	},
/area/ruin/unpowered/misc_lavaruin)
"yH" = (
/obj/structure/shuttle/engine/propulsion/burst{
	dir = 4
	},
/turf/simulated/floor/plating/lavaland_air,
/area/ruin/unpowered/misc_lavaruin)
"yR" = (
/obj/item/stack/sheet/metal,
/turf/simulated/floor/plating/lavaland_air,
/area/ruin/unpowered/misc_lavaruin)
"zc" = (
/obj/item/stack/sheet/metal,
/turf/simulated/floor/plasteel/lavaland_air{
	icon_state = "brown";
	dir = 8
	},
/area/ruin/unpowered/misc_lavaruin)
"zl" = (
/obj/structure/cable/orange{
	icon_state = "2-4"
	},
/turf/simulated/floor/plasteel/lavaland_air,
/area/ruin/unpowered/misc_lavaruin)
"zW" = (
/obj/item/stack/tile,
/turf/simulated/floor/plating/lavaland_air,
/area/ruin/unpowered/misc_lavaruin)
"Ab" = (
/obj/structure/cable/orange{
	icon_state = "4-8"
	},
/turf/simulated/floor/plating/lavaland_air,
/area/ruin/unpowered/misc_lavaruin)
"Au" = (
/obj/machinery/power/terminal{
	dir = 1
	},
/obj/structure/cable/orange{
	icon_state = "0-2"
	},
/turf/simulated/floor/catwalk,
/area/ruin/unpowered/misc_lavaruin)
"Bn" = (
/obj/structure/closet/secure_closet/personal,
/turf/simulated/floor/plasteel/lavaland_air{
	icon_state = "brown";
	dir = 10
	},
/area/ruin/unpowered/misc_lavaruin)
"CL" = (
/obj/item/stack/sheet/metal,
/obj/structure/cable/orange{
	icon_state = "4-8"
	},
/turf/simulated/floor/plasteel/lavaland_air{
	icon_state = "brown";
	dir = 1
	},
/area/ruin/unpowered/misc_lavaruin)
"CO" = (
/obj/structure/cable/orange{
	icon_state = "4-8"
	},
/turf/simulated/floor/plasteel/lavaland_air{
	icon_state = "brown";
	dir = 1
	},
/area/ruin/unpowered/misc_lavaruin)
"Dt" = (
/turf/simulated/floor/plating/lavaland_air,
/area/ruin/unpowered/misc_lavaruin)
"Du" = (
/obj/machinery/suit_storage_unit/lavaland,
/turf/simulated/floor/plasteel/lavaland_air{
	icon_state = "brown";
	dir = 4
	},
/area/ruin/unpowered/misc_lavaruin)
"DA" = (
/turf/simulated/wall/mineral/titanium,
/area/ruin/unpowered/misc_lavaruin)
"DS" = (
/obj/machinery/door/airlock/external/glass,
/turf/simulated/floor/plasteel/lavaland_air,
/area/ruin/unpowered/misc_lavaruin)
"DX" = (
/obj/effect/spawner/window/shuttle,
/turf/simulated/floor/plating/lavaland_air,
/area/ruin/unpowered/misc_lavaruin)
"Ea" = (
/turf/simulated/floor/lava/mapping_lava,
/area/template_noop)
"Er" = (
/obj/effect/spawner/window/reinforced/grilled,
/obj/effect/mapping_helpers/damaged_window,
/turf/simulated/floor/plating,
/area/ruin/unpowered/misc_lavaruin)
"Fc" = (
/obj/structure/closet/secure_closet/personal,
/turf/simulated/floor/plasteel/lavaland_air{
	icon_state = "brown";
	dir = 6
	},
/area/ruin/unpowered/misc_lavaruin)
"FF" = (
/obj/machinery/computer{
	dir = 4;
	icon_state = "broken";
	icon_screen = "broken";
	icon_keyboard = "generic_key_broken"
	},
/turf/simulated/floor/plasteel/lavaland_air{
	icon_state = "titanium_yellow"
	},
/area/ruin/unpowered/misc_lavaruin)
"FY" = (
/obj/structure/mecha_wreckage/ripley/titan,
/turf/simulated/floor/plasteel/lavaland_air,
/area/ruin/unpowered/misc_lavaruin)
"Gu" = (
/obj/structure/cable/orange{
	icon_state = "1-2"
	},
/turf/simulated/floor/plating/lavaland_air,
/area/ruin/unpowered/misc_lavaruin)
"He" = (
/obj/structure/table,
/turf/simulated/floor/plasteel/lavaland_air{
	icon_state = "cautionfull"
	},
/area/ruin/unpowered/misc_lavaruin)
"Ic" = (
/obj/structure/girder,
/turf/simulated/floor/plating,
/area/ruin/unpowered/misc_lavaruin)
"Io" = (
/turf/simulated/floor/plasteel/lavaland_air{
	icon_state = "brown";
	dir = 4
	},
/area/ruin/unpowered/misc_lavaruin)
"IC" = (
/obj/item/stack/tile,
/turf/simulated/floor/plasteel/lavaland_air{
	icon_state = "blue";
	dir = 1
	},
/area/ruin/unpowered/misc_lavaruin)
"IQ" = (
/obj/item/shard{
	icon_state = "small"
	},
/turf/simulated/floor/plasteel/lavaland_air{
	icon_state = "blue";
	dir = 5
	},
/area/ruin/unpowered/misc_lavaruin)
"Ke" = (
/obj/structure/cable/orange{
	icon_state = "4-8"
	},
/obj/structure/cable/orange{
	icon_state = "2-8"
	},
/turf/simulated/floor/plasteel/lavaland_air{
	icon_state = "brown";
	dir = 1
	},
/area/ruin/unpowered/misc_lavaruin)
"Kr" = (
/turf/simulated/floor/plasteel/lavaland_air{
	icon_state = "brown";
	dir = 8
	},
/area/ruin/unpowered/misc_lavaruin)
"Lh" = (
/obj/effect/baseturf_helper/asteroid/basalt,
/turf/simulated/wall,
/area/ruin/unpowered/misc_lavaruin)
"LE" = (
/obj/structure/cable/orange{
	icon_state = "1-8"
	},
/turf/simulated/floor/plasteel/lavaland_air{
	icon_state = "brown";
	dir = 5
	},
/area/ruin/unpowered/misc_lavaruin)
"LJ" = (
/obj/effect/decal/cleanable/glass,
/obj/item/shard,
/obj/structure/grille/broken,
/turf/simulated/floor/plating/lavaland_air,
/area/ruin/unpowered/misc_lavaruin)
"LX" = (
/obj/structure/closet/secure_closet/personal,
/turf/simulated/floor/plasteel/lavaland_air{
	icon_state = "brown"
	},
/area/ruin/unpowered/misc_lavaruin)
"LZ" = (
/obj/structure/cable/orange{
	icon_state = "2-8"
	},
/obj/structure/cable/orange{
	icon_state = "0-8"
	},
/obj/item/mounted/frame/apc_frame{
	pixel_x = 3;
	pixel_y = -8
	},
/turf/simulated/floor/catwalk,
/area/ruin/unpowered/misc_lavaruin)
"Mc" = (
/obj/structure/cable/orange{
	icon_state = "1-2"
	},
/obj/machinery/door/airlock/mining,
/obj/effect/mapping_helpers/machinery/damaged,
/turf/simulated/floor/plasteel/lavaland_air,
/area/ruin/unpowered/misc_lavaruin)
"Mm" = (
/obj/machinery/door/airlock/external/glass,
/turf/simulated/floor/plating/lavaland_air,
/area/ruin/unpowered/misc_lavaruin)
"Na" = (
/obj/item/shard,
/turf/simulated/floor/plasteel/lavaland_air{
	icon_state = "cautionfull"
	},
/area/ruin/unpowered/misc_lavaruin)
"Nc" = (
/obj/structure/cable/orange{
	icon_state = "0-4"
	},
/obj/item/mounted/frame/apc_frame{
	pixel_x = -6
	},
/turf/simulated/floor/plasteel/lavaland_air,
/area/ruin/unpowered/misc_lavaruin)
"Nr" = (
/obj/structure/table_frame,
/obj/item/stack/sheet/metal,
/turf/simulated/floor/plating/lavaland_air,
/area/ruin/unpowered/misc_lavaruin)
"Ny" = (
/obj/effect/turf_decal/stripes/red/line{
	dir = 1
	},
/turf/simulated/floor/plasteel/lavaland_air{
	icon_state = "titanium"
	},
/area/ruin/unpowered/misc_lavaruin)
"NT" = (
/obj/item/stack/sheet/metal,
/turf/simulated/floor/plasteel/lavaland_air{
	icon_state = "brown"
	},
/area/ruin/unpowered/misc_lavaruin)
"NW" = (
/turf/simulated/floor/plasteel/lavaland_air{
	icon_state = "blue";
	dir = 9
	},
/area/ruin/unpowered/misc_lavaruin)
"Oo" = (
/obj/structure/ore_box,
/obj/effect/turf_decal/delivery/hollow,
/obj/effect/turf_decal/stripes/red/line{
	dir = 1
	},
/turf/simulated/floor/plasteel/lavaland_air{
	icon_state = "titanium"
	},
/area/ruin/unpowered/misc_lavaruin)
"OL" = (
/obj/structure/cable/orange{
	icon_state = "4-8"
	},
/turf/simulated/floor/plasteel/lavaland_air,
/area/ruin/unpowered/misc_lavaruin)
"PS" = (
/obj/structure/cable/orange{
	icon_state = "4-8"
	},
/turf/simulated/floor/catwalk,
/area/ruin/unpowered/misc_lavaruin)
"QR" = (
/obj/effect/spawner/window/reinforced/grilled,
/turf/simulated/floor/plating,
/area/ruin/unpowered/misc_lavaruin)
"Rs" = (
/turf/simulated/floor/plasteel/lavaland_air{
	icon_state = "blue";
	dir = 6
	},
/area/ruin/unpowered/misc_lavaruin)
"RE" = (
/obj/machinery/door/airlock/mining,
/turf/simulated/floor/plasteel/lavaland_air,
/area/ruin/unpowered/misc_lavaruin)
"St" = (
/obj/machinery/power/smes,
/obj/structure/cable/orange{
	icon_state = "0-4"
	},
/obj/effect/mapping_helpers/machinery/damaged,
/turf/simulated/floor/catwalk,
/area/ruin/unpowered/misc_lavaruin)
"Sy" = (
/obj/structure/cable/orange{
	icon_state = "4-8"
	},
/obj/structure/cable/orange{
	icon_state = "1-8"
	},
/turf/simulated/floor/plating/lavaland_air,
/area/ruin/unpowered/misc_lavaruin)
"Td" = (
/obj/machinery/door/airlock/mining,
/obj/effect/mapping_helpers/machinery/damaged,
/turf/simulated/floor/plasteel/lavaland_air,
/area/ruin/unpowered/misc_lavaruin)
"TL" = (
/obj/item/stack/tile,
/turf/simulated/floor/plasteel/lavaland_air,
/area/ruin/unpowered/misc_lavaruin)
"TW" = (
/obj/effect/spawner/window/reinforced/grilled,
/turf/simulated/floor/plating/lavaland_air,
/area/ruin/unpowered/misc_lavaruin)
"TX" = (
/obj/structure/cable/orange{
	icon_state = "1-2"
	},
/turf/simulated/floor/catwalk,
/area/ruin/unpowered/misc_lavaruin)
"Ur" = (
/obj/effect/turf_decal/stripes/red/line{
	dir = 1
	},
/obj/effect/turf_decal/stripes/red/line{
	dir = 8
	},
/turf/simulated/floor/plasteel/lavaland_air{
	icon_state = "titanium"
	},
/area/ruin/unpowered/misc_lavaruin)
"UL" = (
/obj/structure/chair/comfy/shuttle{
	dir = 8
	},
/turf/simulated/floor/plasteel/lavaland_air{
	icon_state = "titanium_yellow"
	},
/area/ruin/unpowered/misc_lavaruin)
"Vc" = (
/obj/machinery/suit_storage_unit,
/turf/simulated/floor/plasteel/lavaland_air{
	icon_state = "brown";
	dir = 8
	},
/area/ruin/unpowered/misc_lavaruin)
"Vn" = (
/obj/structure/cable/orange{
	icon_state = "1-4"
	},
/turf/simulated/floor/catwalk,
/area/ruin/unpowered/misc_lavaruin)
"WW" = (
/obj/structure/cable/orange{
	icon_state = "1-4"
	},
/turf/simulated/floor/plasteel/lavaland_air,
/area/ruin/unpowered/misc_lavaruin)
"Xu" = (
/obj/structure/cable/orange{
	icon_state = "4-8"
	},
/obj/machinery/door/airlock/maintenance/external,
/obj/effect/mapping_helpers/machinery/damaged,
/turf/simulated/floor/catwalk,
/area/ruin/unpowered/misc_lavaruin)
"Zh" = (
/obj/structure/cable/orange{
	icon_state = "0-4"
	},
/obj/item/mounted/frame/apc_frame{
	pixel_x = 10
	},
/turf/simulated/floor/plasteel/lavaland_air{
	icon_state = "brown";
	dir = 9
	},
/area/ruin/unpowered/misc_lavaruin)
"Zo" = (
/obj/machinery/suit_storage_unit/lavaland,
/turf/simulated/floor/plasteel/lavaland_air{
	icon_state = "brown";
	dir = 8
	},
/area/ruin/unpowered/misc_lavaruin)

(1,1,1) = {"
cJ
cJ
cJ
cJ
cJ
cJ
cJ
cJ
cJ
cJ
cJ
cJ
cJ
cJ
cJ
cJ
cJ
cJ
cJ
cJ
cJ
cJ
cJ
cJ
cJ
cJ
cJ
cJ
cJ
cJ
cJ
cJ
cJ
cJ
cJ
cJ
cJ
cJ
cJ
cJ
"}
(2,1,1) = {"
cJ
cJ
cJ
cJ
cJ
cJ
cJ
cJ
cJ
cJ
cJ
cJ
cJ
cJ
cJ
cJ
cJ
cJ
cJ
cJ
cJ
cJ
cJ
cJ
cJ
cJ
cJ
cJ
cJ
cJ
cJ
cJ
cJ
cJ
cJ
cJ
cJ
cJ
cJ
cJ
"}
(3,1,1) = {"
cJ
cJ
cJ
cJ
cJ
cJ
cJ
cJ
cJ
cJ
cJ
cJ
cJ
cJ
cJ
cJ
cJ
cJ
cJ
cJ
cJ
cJ
cJ
cJ
cJ
cJ
cJ
cJ
cJ
cJ
cJ
cJ
cJ
cJ
cJ
cJ
cJ
cJ
cJ
cJ
"}
(4,1,1) = {"
cJ
cJ
cJ
cJ
cJ
cJ
cJ
cJ
cJ
cJ
cJ
cJ
cJ
cJ
cJ
cJ
cJ
cJ
cJ
cJ
cJ
cJ
cJ
cJ
cJ
cJ
cJ
cJ
cJ
cJ
cJ
cJ
cJ
cJ
cJ
cJ
cJ
cJ
cJ
cJ
"}
(5,1,1) = {"
cJ
cJ
cJ
cJ
cJ
cJ
cJ
cJ
cJ
cJ
cJ
cJ
cJ
cJ
cJ
cJ
cJ
cJ
cJ
cJ
cJ
cJ
cJ
cJ
cJ
cJ
cJ
cJ
cJ
cJ
cJ
cJ
cJ
cJ
cJ
cJ
cJ
cJ
cJ
cJ
"}
(6,1,1) = {"
cJ
cJ
cJ
cJ
cJ
cJ
cJ
cJ
cJ
cJ
cJ
cJ
cJ
cJ
cJ
cJ
cJ
hx
en
en
en
hx
en
cJ
cJ
cJ
cJ
cJ
cJ
cJ
cJ
cJ
cJ
cJ
cJ
cJ
cJ
cJ
cJ
cJ
"}
(7,1,1) = {"
cJ
cJ
cJ
cJ
cJ
cJ
cJ
cJ
cJ
cJ
cJ
cJ
cJ
cJ
cJ
cJ
cJ
hx
St
Au
TX
lT
en
cJ
cJ
cJ
cJ
cJ
cJ
cJ
cJ
cJ
cJ
cJ
cJ
cJ
cJ
cJ
cJ
cJ
"}
(8,1,1) = {"
cJ
cJ
cJ
cJ
cJ
cJ
cJ
cJ
cJ
cJ
cJ
cJ
cJ
cJ
cJ
cJ
cJ
hx
PS
Dt
Dt
Dt
en
DS
DS
en
cJ
cJ
cJ
cJ
cJ
cJ
cJ
cJ
cJ
cJ
cJ
cJ
cJ
cJ
"}
(9,1,1) = {"
cJ
cJ
cJ
cJ
cJ
cJ
cJ
cJ
cJ
cJ
nt
DX
DX
cJ
cJ
cJ
cJ
en
LZ
TX
TX
Vn
en
pv
Dt
po
cJ
cJ
cJ
cJ
cJ
cJ
cJ
cJ
cJ
cJ
cJ
cJ
cJ
cJ
"}
(10,1,1) = {"
cJ
cJ
cJ
cJ
cJ
cJ
cJ
cJ
cJ
DX
nt
FF
nt
nt
cJ
cJ
hx
en
en
en
Dt
PS
en
Dt
Dt
po
cJ
cJ
cJ
cJ
cJ
cJ
cJ
cJ
cJ
cJ
cJ
cJ
cJ
cJ
"}
(11,1,1) = {"
cJ
cJ
cJ
cJ
cJ
cJ
cJ
cJ
cJ
DA
UL
UL
UL
DA
cJ
cJ
en
Dt
hi
TX
TX
fW
en
DS
Mm
en
cJ
cJ
cJ
cJ
cJ
cJ
cJ
cJ
Ea
cJ
cJ
cJ
cJ
cJ
"}
(12,1,1) = {"
cJ
cJ
cJ
cJ
cJ
cJ
cJ
cJ
cJ
DX
vw
vw
vw
nt
en
en
en
en
Xu
hx
hx
en
en
hp
yA
en
en
po
TW
en
en
Ea
Ea
Ea
Ea
cJ
cJ
cJ
cJ
cJ
"}
(13,1,1) = {"
cJ
cJ
cJ
cJ
cJ
cJ
cJ
cJ
cJ
oU
Ur
sE
gb
oU
Mm
Kr
Kr
Kr
Ab
Kr
zc
Kr
bE
Dt
yA
en
Nc
pv
pv
TL
hx
Ea
Ea
cJ
cJ
cJ
cJ
cJ
cJ
cJ
"}
(14,1,1) = {"
cJ
cJ
cJ
cJ
cJ
cJ
cJ
cJ
cJ
oU
Ny
xf
nz
oU
Mm
Io
Dt
Io
im
Gu
Gu
rp
oC
WW
yA
en
OL
pv
Dt
Ea
Ea
Ea
cJ
cJ
cJ
cJ
cJ
cJ
cJ
cJ
"}
(15,1,1) = {"
cJ
cJ
cJ
cJ
cJ
cJ
cJ
cJ
cJ
nt
Oo
ms
wA
DX
en
en
en
hx
en
QR
Er
en
Lh
Ke
sD
Mc
lW
Ea
Ea
Ea
Ea
cJ
cJ
cJ
cJ
cJ
cJ
cJ
cJ
cJ
"}
(16,1,1) = {"
cJ
cJ
cJ
cJ
cJ
cJ
cJ
cJ
cJ
DA
Oo
ms
wA
DA
cJ
cJ
cJ
en
Dt
aR
aR
gu
en
CO
zW
hx
Ea
Ea
Ea
su
LJ
cJ
cJ
cJ
cJ
cJ
cJ
cJ
cJ
cJ
"}
(17,1,1) = {"
cJ
cJ
cJ
cJ
cJ
cJ
cJ
cJ
cJ
DA
fG
jw
vp
DA
cJ
cJ
cJ
en
aR
ko
bw
aR
Ic
CL
Dt
Ea
Ea
Ea
yR
dA
ga
cJ
cJ
cJ
cJ
cJ
cJ
cJ
cJ
cJ
"}
(18,1,1) = {"
cJ
cJ
cJ
cJ
cJ
cJ
cJ
cJ
cJ
DA
yH
yH
yH
DA
cJ
cJ
cJ
Er
aR
He
He
Dt
Ic
OL
Ea
Ea
Ea
wt
Dt
pv
en
cJ
cJ
cJ
cJ
cJ
cJ
cJ
cJ
cJ
"}
(19,1,1) = {"
cJ
cJ
cJ
cJ
cJ
cJ
cJ
cJ
cJ
cJ
cJ
cJ
cJ
cJ
cJ
cJ
cJ
Er
Dt
gu
aR
Dt
Td
Ea
Ea
Ea
hx
hx
hx
en
en
cJ
cJ
cJ
cJ
cJ
cJ
cJ
cJ
cJ
"}
(20,1,1) = {"
cJ
cJ
cJ
cJ
cJ
cJ
cJ
cJ
cJ
cJ
cJ
cJ
cJ
cJ
cJ
cJ
cJ
hx
qP
Dt
Dt
sh
Ea
Ea
Ea
hx
Zo
Vc
kX
en
cJ
cJ
cJ
cJ
cJ
cJ
cJ
cJ
cJ
cJ
"}
(21,1,1) = {"
cJ
cJ
cJ
cJ
cJ
cJ
cJ
cJ
cJ
cJ
cJ
cJ
cJ
cJ
cJ
cJ
cJ
fC
pu
Dt
aR
Ea
Ea
Ea
yA
hx
pv
pv
pv
en
cJ
cJ
cJ
cJ
cJ
cJ
cJ
cJ
cJ
cJ
"}
(22,1,1) = {"
cJ
cJ
cJ
cJ
cJ
cJ
cJ
cJ
cJ
cJ
cJ
cJ
cJ
cJ
cJ
cJ
cJ
ov
Nr
Na
Ea
Ea
Ea
CO
Dt
Td
pv
iO
iO
en
cJ
cJ
cJ
cJ
cJ
cJ
cJ
cJ
cJ
cJ
"}
(23,1,1) = {"
cJ
cJ
cJ
cJ
cJ
cJ
cJ
cJ
cJ
cJ
cJ
cJ
cJ
cJ
cJ
cJ
cJ
hx
Ea
Ea
Ea
Ea
Ea
CO
Dt
en
pv
pv
pv
en
cJ
cJ
cJ
cJ
cJ
cJ
cJ
cJ
cJ
cJ
"}
(24,1,1) = {"
cJ
cJ
cJ
cJ
cJ
cJ
cJ
cJ
cJ
cJ
cJ
cJ
cJ
cJ
cJ
cJ
cJ
Ea
Ea
Ea
Ea
Ea
hx
CO
NT
en
cd
Du
ra
en
cJ
cJ
cJ
cJ
cJ
cJ
cJ
cJ
cJ
cJ
"}
(25,1,1) = {"
cJ
cJ
cJ
cJ
cJ
cJ
cJ
cJ
cJ
cJ
cJ
cJ
cJ
cJ
cJ
Ea
Ea
Ea
Ea
Ea
Ea
Ea
hx
CL
yA
en
en
en
en
en
cJ
cJ
cJ
cJ
cJ
cJ
cJ
cJ
cJ
cJ
"}
(26,1,1) = {"
cJ
cJ
cJ
cJ
cJ
cJ
cJ
cJ
cJ
cJ
cJ
cJ
cJ
cJ
cJ
Ea
Ea
Ea
Ea
Ea
yR
hx
hx
Ab
Dt
en
NW
Dt
LJ
cJ
cJ
cJ
cJ
cJ
cJ
cJ
cJ
cJ
cJ
cJ
"}
(27,1,1) = {"
cJ
cJ
cJ
cJ
cJ
cJ
cJ
cJ
cJ
cJ
cJ
cJ
cJ
cJ
Ea
Ea
Ea
Ea
Ea
hx
tB
zl
um
Sy
pv
RE
IC
Dt
po
cJ
cJ
cJ
cJ
cJ
cJ
cJ
cJ
cJ
cJ
cJ
"}
(28,1,1) = {"
cJ
cJ
cJ
cJ
cJ
cJ
cJ
cJ
cJ
cJ
cJ
cJ
cJ
cJ
Ea
Ea
Ea
Ea
cJ
hx
Dt
bu
en
CO
Dt
en
IQ
Rs
po
cJ
cJ
cJ
cJ
cJ
cJ
cJ
cJ
cJ
cJ
cJ
"}
(29,1,1) = {"
cJ
cJ
cJ
cJ
cJ
cJ
cJ
cJ
cJ
cJ
cJ
cJ
cJ
Ea
Ea
Ea
Ea
cJ
cJ
en
pv
pv
en
CO
yA
en
en
en
en
cJ
cJ
cJ
cJ
cJ
cJ
cJ
cJ
cJ
cJ
cJ
"}
(30,1,1) = {"
cJ
cJ
cJ
cJ
cJ
cJ
cJ
cJ
cJ
cJ
cJ
cJ
Ea
Ea
Ea
cJ
cJ
cJ
cJ
en
FY
hR
en
CO
Dt
en
Zh
Bn
TW
cJ
cJ
cJ
cJ
cJ
cJ
cJ
cJ
cJ
cJ
cJ
"}
(31,1,1) = {"
cJ
cJ
cJ
cJ
cJ
cJ
cJ
cJ
cJ
cJ
Ea
Ea
Ea
cJ
cJ
cJ
cJ
cJ
cJ
en
po
po
en
CO
Dt
en
CO
LX
po
cJ
cJ
cJ
cJ
cJ
cJ
cJ
cJ
cJ
cJ
cJ
"}
(32,1,1) = {"
cJ
cJ
cJ
cJ
cJ
cJ
cJ
cJ
cJ
cJ
cJ
cJ
cJ
cJ
cJ
cJ
cJ
cJ
cJ
Mm
pv
zW
Mm
ll
sD
um
LE
Fc
TW
cJ
cJ
cJ
cJ
cJ
cJ
cJ
cJ
cJ
cJ
cJ
"}
(33,1,1) = {"
cJ
cJ
cJ
cJ
cJ
cJ
cJ
cJ
cJ
cJ
cJ
cJ
cJ
cJ
cJ
cJ
cJ
cJ
cJ
Mm
Dt
pv
DS
Io
Io
en
ov
TW
en
cJ
cJ
cJ
cJ
cJ
cJ
cJ
cJ
cJ
cJ
cJ
"}
(34,1,1) = {"
cJ
cJ
cJ
cJ
cJ
cJ
cJ
cJ
cJ
cJ
cJ
cJ
cJ
cJ
cJ
cJ
cJ
cJ
cJ
en
TW
po
en
po
po
en
cJ
cJ
cJ
cJ
cJ
cJ
cJ
cJ
cJ
cJ
cJ
cJ
cJ
cJ
"}
(35,1,1) = {"
cJ
cJ
cJ
cJ
cJ
cJ
cJ
cJ
cJ
cJ
cJ
cJ
cJ
cJ
cJ
cJ
cJ
cJ
cJ
cJ
cJ
cJ
cJ
cJ
cJ
cJ
cJ
cJ
cJ
cJ
cJ
cJ
cJ
cJ
cJ
cJ
cJ
cJ
cJ
cJ
"}
(36,1,1) = {"
cJ
cJ
cJ
cJ
cJ
cJ
cJ
cJ
cJ
cJ
cJ
cJ
cJ
cJ
cJ
cJ
cJ
cJ
cJ
cJ
cJ
cJ
cJ
cJ
cJ
cJ
cJ
cJ
cJ
cJ
cJ
cJ
cJ
cJ
cJ
cJ
cJ
cJ
cJ
cJ
"}
(37,1,1) = {"
cJ
cJ
cJ
cJ
cJ
cJ
cJ
cJ
cJ
cJ
cJ
cJ
cJ
cJ
cJ
cJ
cJ
cJ
cJ
cJ
cJ
cJ
cJ
cJ
cJ
cJ
cJ
cJ
cJ
cJ
cJ
cJ
cJ
cJ
cJ
cJ
cJ
cJ
cJ
cJ
"}
(38,1,1) = {"
cJ
cJ
cJ
cJ
cJ
cJ
cJ
cJ
cJ
cJ
cJ
cJ
cJ
cJ
cJ
cJ
cJ
cJ
cJ
cJ
cJ
cJ
cJ
cJ
cJ
cJ
cJ
cJ
cJ
cJ
cJ
cJ
cJ
cJ
cJ
cJ
cJ
cJ
cJ
cJ
"}
(39,1,1) = {"
cJ
cJ
cJ
cJ
cJ
cJ
cJ
cJ
cJ
cJ
cJ
cJ
cJ
cJ
cJ
cJ
cJ
cJ
cJ
cJ
cJ
cJ
cJ
cJ
cJ
cJ
cJ
cJ
cJ
cJ
cJ
cJ
cJ
cJ
cJ
cJ
cJ
cJ
cJ
cJ
"}
(40,1,1) = {"
cJ
cJ
cJ
cJ
cJ
cJ
cJ
cJ
cJ
cJ
cJ
cJ
cJ
cJ
cJ
cJ
cJ
cJ
cJ
cJ
cJ
cJ
cJ
cJ
cJ
cJ
cJ
cJ
cJ
cJ
cJ
cJ
cJ
cJ
cJ
cJ
cJ
cJ
cJ
cJ
"}
