//MAP CONVERTED BY dmm2tgm.py THIS HEADER COMMENT PREVENTS RECONVERSION, DO NOT REMOVE
"a" = (
/turf/space,
/area/space)
"c" = (
/turf/simulated/wall/indestructible/whiteshuttle,
/area/space)
"g" = (
/turf/simulated/floor/mineral/titanium,
/area/space)
"t" = (
/obj/effect/landmark/awaymissions/spacebattle/mine_spawner{
	id = "bupa"
	},
/turf/simulated/floor/mineral/titanium,
/area/space)
"w" = (
/obj/effect/landmark/awaymissions/spacebattle/mob_spawn/melee{
	id = "bup"
	},
/turf/simulated/floor/mineral/titanium,
/area/space)
"F" = (
/obj/effect/landmark/awaymissions/spacebattle/mine_spawner{
	id = "bup"
	},
/turf/simulated/floor/mineral/titanium,
/area/space)
"G" = (
/obj/effect/landmark/awaymissions/spacebattle/mob_spawn/drone{
	id = "bupa"
	},
/turf/simulated/floor/mineral/titanium,
/area/space)

(1,1,1) = {"
a
a
a
a
a
a
a
a
a
a
a
a
a
a
a
a
a
a
a
a
"}
(2,1,1) = {"
a
a
a
a
a
a
a
a
a
a
a
a
a
a
a
a
a
a
a
a
"}
(3,1,1) = {"
a
a
a
a
a
a
a
a
a
a
a
a
a
a
a
a
a
a
a
a
"}
(4,1,1) = {"
a
a
a
a
c
c
c
c
c
c
c
c
c
c
c
c
a
a
a
a
"}
(5,1,1) = {"
a
a
a
a
c
g
g
g
g
g
g
g
g
g
g
c
a
a
a
a
"}
(6,1,1) = {"
a
a
a
a
c
g
g
g
g
g
g
g
g
g
g
c
a
a
a
a
"}
(7,1,1) = {"
a
a
a
a
c
g
g
w
g
g
g
g
g
g
g
c
a
a
a
a
"}
(8,1,1) = {"
a
a
a
a
c
g
g
g
g
g
g
g
g
g
g
c
a
a
a
a
"}
(9,1,1) = {"
a
a
a
a
c
g
g
g
g
g
g
g
g
g
g
c
a
a
a
a
"}
(10,1,1) = {"
a
a
a
a
c
g
g
F
g
g
g
g
g
g
g
c
a
a
a
a
"}
(11,1,1) = {"
a
a
a
a
c
g
g
g
g
g
g
g
g
g
G
c
a
a
a
a
"}
(12,1,1) = {"
a
a
a
a
c
g
g
g
g
g
g
g
g
g
g
c
a
a
a
a
"}
(13,1,1) = {"
a
a
a
a
c
g
g
t
g
g
g
g
g
g
g
c
a
a
a
a
"}
(14,1,1) = {"
a
a
a
a
c
g
g
g
g
g
g
g
g
g
g
c
a
a
a
a
"}
(15,1,1) = {"
a
a
a
a
c
g
g
g
g
g
g
g
g
g
g
c
a
a
a
a
"}
(16,1,1) = {"
a
a
a
a
c
g
g
g
g
g
g
g
g
g
g
c
a
a
a
a
"}
(17,1,1) = {"
a
a
a
a
c
c
c
c
c
c
c
c
c
c
c
c
a
a
a
a
"}
(18,1,1) = {"
a
a
a
a
a
a
a
a
a
a
a
a
a
a
a
a
a
a
a
a
"}
(19,1,1) = {"
a
a
a
a
a
a
a
a
a
a
a
a
a
a
a
a
a
a
a
a
"}
(20,1,1) = {"
a
a
a
a
a
a
a
a
a
a
a
a
a
a
a
a
a
a
a
a
"}
